WWWWWWCWWW
......P...
M.....M...
..s.......
.......s..
....M.....
...G......
.......s..
.......s..
.G..M.....
..........
..s.......
.......GG.
s.........
.s........