WWWWWWWWWCWWWWWWWWWWWWWWWW
.s..G....PM.GsL....G......
...MG.A......GssG..G.R....
....G..............G......
.M..G..GG...ss.....G......
....G....ssR.......G......
....G..............G......
..R.G.M.........M..G..L...
.G..GL....M...sGsG.G......
....G...M.A...sR...G......
....G.............RG......
..L.GGGGGGGGGGGGGGGG.s....
.....A.......M............
..G....R..................
..........................
..........................