wwwwwwhwww
.s.f......
psb..b.p..
.s..fBBf..
.....tt...
...n..t...
......bf..
.ff...tt..
.f......S.
........b.
....P...b.
...ss.....
..B.......
.......pfp
ssssssssss
.....n....
