wwwwwwwwwwwwwwwwwww
.s.f...............
psb..b.p...........
.s..fBBf...........
.....tt............
.r....t............
......bf...........
.ff...tt...........
.f......S..........
........b..........
....P.Q.b..........
...................
...................
.......pfp.........
wwwwwwwwwwwwwwwwwww
...................
...................