WWWWWWWWWCWWWWWWWWWWWWWWWW
.s..G....PM.GsL....G......
...MG........GssG..G.R....
....G..............G......
.M..G..GG...ss.....G......
....G....ssR.......G......
....G..............G......
..R.G.M.........M..G..L...
.G..GL....M...sGsG.G......
....G...M.....sR...G......
....G.............RG......
..L.GGGGGGGGGGGGGGGG.s....
.............M............
..G....R..................
..........................
..........................