YYYYYYYYYYYDYYYYYYYYYYYYYYYYYYYYYYYYYYYYYYYYYYYYYYYYYYYYYYYYYYYYY
...s..G....PM.Gsi....G.....................g.................g...
.....MG........GssG..G.j............j............................
......G..............G.........g..................H..............
...M..G..GG...ss.....G...........................................
......G....ssj.......G..........................GGGGGGGGGGG......
......G......Q.......GQ...........GGGGG........G...xX.....gG.....
....j.G.M.........M..G..i........GHM...G........G..........G.....
...G..Gi....M...sGsG.G...........G.....G.........GH...Q...G......
......G...M.....sj...G.....g.....G...g.G.....s....G......G.......
......G.............jG..........G......G..........G.....G........
...J..G.....J........GGGGGGGGGGG.......G..ss......G....G.........
......G.s.....g.......................G............G..Gs.........
......G..............GGGGGGGGGGG.....G.....GGGGGGGGG..GG.........
....i.GGG..GGGGGGGGGGG.s........G.GGG....GGJ...........G.........
........G..G...M................G...GGGGG.....Qg.....GG..........
....G...G..G...................g.G..................G.......g....
.......G....G.Q........g.........GGGG...Jg........GG.............
......G......G......................JGGGGGGGGGGGGG...G........... 
.....G........GGGGGGGGGGG...s....J...........J........G..........
.....G...................GG..s........................G..j.......
.....G..xX....GGGGGGGG....GG..ss....i.....g......................
......GGGGGGGG........GG....G...s.....................G..........
........s.....G...J.....GG...GGGGGGGGGGGGGG....j....JG...........
...............GG..GGG...JG.............J..GG.......G............
.......g.........GG...G...G....Q..s..........GGG.....G...........
..............sg.......G.G.........ssQ.....i....G.....G...g......
....................i....G...jg......s..........G.J..iG..........
......s.................J.G...J....g......xX.....G...G...........
...........J...............GGGGGGGGGGGGGGGGGGGGGG...G............
.........................GG.s..........Q.........G..G.....s......
......................J.G.......J.....j...........GG.............
............ss...........G...........................J...........
............................g......s.............s...............
..................s..............................................
.................s..s......................i.....................
.....................s...........................................
.................................................................
.................................................................
.................................................................
