YYYYYYYYYYYDYYYYYYYYYYYYYYYYYYYY
...s..G....PM.Gsi....G..........
.....MG........GssG..G.j........
......G..............G..........
...M..G..GG...ss.....G..........
......G....ssj.......G..........
......G......Q.......GQ.........
....j.G.M.........M..G..i.......
...G..Gi....M...sGsG.G..........
......G...M.....sj...G..........
......G.............jG..........
....i.GGGGGGGGGGGGGGGG.s........
...............M................
....G....j......................
..............Q.................
................................ 
................................
................................