ZZZZZZZZZZZZZZZZZZZZZZZZZZ
..........................
..........................
.........................
..........................
....T.....................
........b..................
......B...................
.........................
..........................
..........................
..........................
..........................
..........................
..........................
..........................
