wwwwwwhwww
.s.f......
psb..b.p..
.s..fBBf..
.....tt...b
......t...
......bf..
.ff...tt..p
.f......s.s
........b.
........b.
...ss.....
..B.......b
.......pfp
..........