wwwwwwhwww
.s.f......
psb..b.p..
.s..fBBf..
.....tt...
...n..t...
......bf..
.ff...tt..
.f......s.
........b.
........b.
...ss.....
..B.......
.......pfp
.....n....