wwwwwwhwww...
.s.f.........
psb..b.p.....
.s..fBBf.....
.....tt......
....T..t.....
......bf.....
.ff...tt.....
.f......s....
........b....
........b....
...ss........
..B..........
.......pfp...
.............
.............