wwwwwwhwww
.s.fU..M..
psb..b.p..
.s..fBBf..
.....tt...
..hh..t...
......bf..
.ff...tt..
.f.kk...S.
...ww...b.
........b.
...ss.....
..B..hhh..
.......pfp
ssssssssss