wwwwwwhwww
.s.f......
psb..b.p..
.s..fBBf..
.....tt...
..hh..t...
......bf..
.ff...tt..
.f.kk...S.
...ww...b.
....P...b.
...ss.....
..B..hhh..
.......pfp
ssssssssss