ZZZZZZZZZZZZZZZZZZZZZZZZZZ
..........................
..........................
.........................
..........................
....T.....................
..........................
......B...................
..........Z...............
..........................
..........................
..........................
..........................
..........................
..........................
..........................