wwwwwwhwww
.s.s......
psb..b.p..
.s..fBBf..
.....tt...
......t...
......bf..
.ff...tt..
.f......s.
...pp...b.
...ss....b.
...ssssss.
..B.......
.......pfp
...pppp...