wwwwwwhwww
.s.f......
psb..b.p..
.s..fBBf..
.....tt...
......t...
......bf..
.ff...tt..
.f......s.
........b.
........b.
...ssssss.
..B.......
.......pfp
..........